1111111111111111111
100C000000C000000E1
1000000000000000001
100C000000000000001
1000000C0C0C0000001
1000C00C0C0C0000001
1000000C0C0C0000001
100C000C0C0C0000001
1000000C000C0000011
1000000C0C0C0000001
1P00000C0C0C00000E1
1111111111111111111